{
	"Levels": [
		{
			"Level": [
				5, 5, 5, 5, 5, 5, 5, 5,
				5, 0, 0, 0, 0, 0, 0, 5,
				5, 0, 0, 0, 0, 0, 0, 5,
				5, 0, 0, 0, 0, 0, 0, 5,
				5, 0, 0, 0, 0, 0, 0, 5,
				5, 0, 0, 0, 0, 0, 0, 5,
				5, 0, 0, 0, 0, 0, 0, 5,
				5, 5, 5, 5, 5, 5, 5, 5
			],
			"Blocks": [{
				"Position": [1, 0],
				"Target": [1, 2],
				"Type": "Green"
			}]
		},
		{
			"Level": [
				5, 5, 5, 5, 5, 5, 5, 5,
				5, 0, 0, 0, 0, 0, 0, 5,
				5, 0, 0, 0, 0, 0, 0, 5,
				5, 0, 0, 0, 0, 0, 0, 5,
				5, 0, 0, 0, 0, 0, 0, 5,
				5, 0, 0, 0, 0, 0, 0, 5,
				5, 0, 5, 0, 0, 0, 0, 5,
				5, 5, 5, 5, 5, 5, 5, 5
			],
			"Blocks": [{
				"Position": [-1, 0],
				"Target": [1, 2],
				"Type": "Red"
			}]
		}
	]
	
}